#..........#
#..........#
#...PppP...#
A..........Z
#...PppP...#
#..........#
#..........#