........
..P.....
......p.
A......Z
......p.
..P.....
........