##....P...P..
##...........
##...........
##....p.o.p..
##..O........
aaA...o...O.Z
##..O........
##....p.o.p..
##...........
##...........
##....P...P..