....P...P..
...........
...........
....p.o.p..
..O........
A...o...O.Z
..O........
....p.o.p..
...........
...........
....P...P..