.........#
.........A
..PPPPP..#
.........#
.........#
.........#
..ppppp..#
.........Z
.........#