##a#########
##A#########
...........#
...........#
o...GGG...g#
...........#
...o...g...Z
...........#
o...OOO...g#
...........#
...........#