##a##########
##A##########
#........og##
.....OG.....#
o...........#
.....OG.....Z
g...........#
.....OG.....#
#........og##
