####PGP.....OGO#
####...........#
###............#
Z.....+..+..+..#
###.............
###*..+.....+..*
###.............
aaA...+..+..+..#
###............#
####...........#
####g?o.....p?g#