###PGP.....OGO#
###...........#
##............#
Z....+..+..+..#
##.............
##*..+.....+..*
##.............
aA...+..+..+..#
##............#
###...........#
###g?o.....p?g#