#########a#######
#########a#######
#########A#######
...............##
................Z
...............##
..OO..PP...po..##
...........op.###
...........po..##
..PP..OO...op..##
...............##
...............##
...............##
