#####A######
#####.######
............
............
..P......p..
..P#.....p..
..P.....#p..
..P......p..
Z...........
............